000000000000000
0f000f0f00f0f00
000f0000000000f
0000000f0000000
0ff00f0f00f0000
000f0000000000f
0f000f0f00f0f00
